+---+---+---+---+---+---+---+---+---+---+---+---+---+---+---+---+---+---+---+---+---+---+---+---+---+---+---+---+---+---+---+---+---+---+---+---+---+---+---+---+---+---+---+---+---+---+---+---+---+---+---+---+---+---+---+---+---+---+---+---+---+---+---+
|...|...|...|...|...|...|...|   |   |   |   |   |   |   |   |   |   |   |   |   |   |   |   |   |   |   |   |   |...|...|...|...|...|...|...|...|...|...|...|...|...|...|...|...|...|...|...|...|...|...|...|...|...|...|...|...|...|...|...|...|...|...|...|
|...|...|...|...|...|...|...|   |   |   |   |   |   |   |   |   |   |   |   |   |   |   |   |   |   |   |   |   |...|...|...|...|...|...|...|...|...|...|...|...|...|...|...|...|...|...|...|...|...|...|...|...|...|...|...|...|...|...|...|...|...|...|...|
|...|...|...|...|...|...|...|   |   |   |   |   |   |   |   |   |   |   |   |   |   |   |   |   |   |   |   |   |...|...|...|...|...|...|...|...|...|...|...|...|...|...|...|...|...|...|...|...|...|...|...|...|...|...|...|...|...|...|...|...|...|...|...|
+---+---+---+---+---+---+---+---+---+---+---+---+---+---+---+---+---+---+---+---+---+---+---+---+---+---+---+---+---+---+---+---+---+---+---+---+---+---+---+---+---+---+---+---+---+---+---+---+---+---+---+---+---+---+---+---+---+---+---+---+---+---+---+
|...|...|...|...|...|...|   |   |   |...|...|...|...|...|...|...|   |   |   |   |   |   |   |   |   |   |   |   |...|...|...|...|...|...|...|...|...|...|...|...|...|...|...|...|...|...|...|...|...|...|...|...|...|...|...|...|...|...|...|...|...|...|...|
|...|...|...|...|...|...|   |   |   |...|...|...|...|...|...|...|   |   |   |   |   |   |   |   |   |   |   |   |...|...|...|...|...|...|...|...|...|...|...|...|...|...|...|...|...|...|...|...|...|...|...|...|...|...|...|...|...|...|...|...|...|...|...|
|...|...|...|...|...|...|   |   |   |...|...|...|...|...|...|...|   |   |   |   |   |   |   |   |   |   |   |   |...|...|...|...|...|...|...|...|...|...|...|...|...|...|...|...|...|...|...|...|...|...|...|...|...|...|...|...|...|...|...|...|...|...|...|
+---+---+---+---+---+---+---+---+---+---+---+---+---+---+---+---+---+---+---+---+---+---+---+---+---+---+---+---+---+---+---+---+---+---+---+---+---+---+---+---+---+---+---+---+---+---+---+---+---+---+---+---+---+---+---+---+---+---+---+---+---+---+---+
|...|...|...|...|   |   |   |   |   |   |   |...|...|...|...|...|...|...|...|...|...|...|...|...|...|...|   |   |   |   |   |   |...|...|...|...|...|...|...|...|...|...|...|...|...|...|...|...|...|...|...|...|...|...|...|...|...|...|...|...|...|...|...|
|...|...|...|...|   |   |   |   |   | 3-|-T-|...|...|...|...|...|...|...|...|...|...|...|...|...|...|...|   |   |   |   |   |   |...|...|...|...|...|...|...|...|...|...|...|...|...|...|...|...|...|...|...|...|...|...|...|...|...|...|...|...|...|...|...|
|...|...|...|...|   |   |   |   |   |/  |   |...|...|...|...|...|...|...|...|...|...|...|...|...|...|...|   |   |   |   |   |   |...|...|...|...|...|...|...|...|...|...|...|...|...|...|...|...|...|...|...|...|...|...|...|...|...|...|...|...|...|...|...|
+---+---+---+---+---+---+---+---+---+---+---+---+---+---+---+---+---+---+---+---+---+---+---+---+---+---+---+---+---+---+---+---+---+---+---+---+---+---+---+---+---+---+---+---+---+---+---+---+---+---+---+---+---+---+---+---+---+---+---+---+---+---+---+
|...|...|...|...|   |   |   |   |  /|   |...|...|...|...|...|...|...|...|...|...|...|...|...|...|...|...|...|...|...|...|...|   |   |   |   |   |...|...|...|...|...|...|...|...|...|...|...|...|...|...|...|...|...|...|...|...|...|...|...|...|...|...|...|
|...|...|...|...|   |   |   |   | 3 |   |...|...|...|...|...|...|...|...|...|...|...|...|...|...|...|...|...|...|...|...|...|   |   |   |   |   |...|...|...|...|...|...|...|...|...|...|...|...|...|...|...|...|...|...|...|...|...|...|...|...|...|...|...|
|...|...|...|...|   |   |   |   | | |   |...|...|...|...|...|...|...|...|...|...|...|...|...|...|...|...|...|...|...|...|...|   |   |   |   |   |...|...|...|...|...|...|...|...|...|...|...|...|...|...|...|...|...|...|...|...|...|...|...|...|...|...|...|
+---+---+---+---+---+---+---+---+---+---+---+---+---+---+---+---+---+---+---+---+---+---+---+---+---+---+---+---+---+---+---+---+---+---+---+---+---+---+---+---+---+---+---+---+---+---+---+---+---+---+---+---+---+---+---+---+---+---+---+---+---+---+---+
|...|...|...|...|   |   |   |   | | |   |...|...|...|...|...|...|...|...|...|...|...|...|...|...|...|...|...|...|...|...|...|...|...|...|...|   |   |   |   |   |   |   |   |...|   |...|   |...|...|...|...|...|...|...|...|...|...|...|...|...|...|...|...|
|...|...|...|...|   |   |   |   | 3 |   |...|...|...|...|...|...|...|...|...|...|...|...|...|...|...|...|...|...|...|...|...|...|...|...|...|   |   |   |   |   |   |   |   |...|   |...|   |...|...|...|...|...|...|...|...|...|...|...|...|...|...|...|...|
|...|...|...|...|   |   |   |   |  \|   |...|...|...|...|...|...|...|...|...|...|...|...|...|...|...|...|...|...|...|...|...|...|...|...|...|   |   |   |   |   |   |   |   |...|   |...|   |...|...|...|...|...|...|...|...|...|...|...|...|...|...|...|...|
+---+---+---+---+---+---+---+---+---+---+---+---+---+---+---+---+---+---+---+---+---+---+---+---+---+---+---+---+---+---+---+---+---+---+---+---+---+---+---+---+---+---+---+---+---+---+---+---+---+---+---+---+---+---+---+---+---+---+---+---+---+---+---+
|...|...|...|...|   |   |   |   |   |\  |   |   |   |   |   |   |   |   |   |   |...|...|...|...|...|...|...|...|...|...|...|...|...|...|...|...|...|...|...|...|...|...|...|   |...|   |...|   |...|...|...|...|...|...|...|...|...|...|...|...|...|...|...|
|...|...|...|...|   |   |   |   |   | 2 |   |   |   |   |   |   |   |   |   |   |...|...|...|...|...|...|...|...|...|...|...|...|...|...|...|...|...|...|...|...|...|...|...|   |...|   |...|   |...|...|...|...|...|...|...|...|...|...|...|...|...|...|...|
|...|...|...|...|   |   |   |   |   |  \|   |   |   |   |   |   |   |   |   |   |...|...|...|...|...|...|...|...|...|...|...|...|...|...|...|...|...|...|...|...|...|...|...|   |...|   |...|   |...|...|...|...|...|...|...|...|...|...|...|...|...|...|...|
+---+---+---+---+---+---+---+---+---+---+---+---+---+---+---+---+---+---+---+---+---+---+---+---+---+---+---+---+---+---+---+---+---+---+---+---+---+---+---+---+---+---+---+---+---+---+---+---+---+---+---+---+---+---+---+---+---+---+---+---+---+---+---+
|...|...|...|...|   |   |   |   |   |   |\  |   |   |   |   |   |   |   |   |   |...|...|...|...|...|...|...|...|...|...|...|...|...|...|...|...|...|...|...|...|...|...|...|...|   |...|   |...|...|...|...|...|...|...|...|...|...|...|...|...|...|...|...|
|...|...|...|...|   |   |   |   |   |   | 3-|-2-|-2-|-2-|-2-|-2-|-2-|-3 |   |   |...|...|...|...|...|...|...|...|...|...|...|...|...|...|...|...|...|...|...|...|...|...|...|...|   |...|   |...|...|...|...|...|...|...|...|...|...|...|...|...|...|...|...|
|...|...|...|...|   |   |   |   |   |   |   |   |   |   |   |   |   |  \|   |   |...|...|...|...|...|...|...|...|...|...|...|...|...|...|...|...|...|...|...|...|...|...|...|...|   |...|   |...|...|...|...|...|...|...|...|...|...|...|...|...|...|...|...|
+---+---+---+---+---+---+---+---+---+---+---+---+---+---+---+---+---+---+---+---+---+---+---+---+---+---+---+---+---+---+---+---+---+---+---+---+---+---+---+---+---+---+---+---+---+---+---+---+---+---+---+---+---+---+---+---+---+---+---+---+---+---+---+
|...|...|...|...|...|...|...|...|...|...|...|...|...|...|...|...|...|...|\  |   |...|...|...|...|...|...|...|...|...|...|...|...|...|...|...|...|...|...|...|...|...|...|...|...|...|   |...|...|...|...|...|...|...|...|...|...|...|...|...|...|...|...|...|
|...|...|...|...|...|...|...|...|...|...|...|...|...|...|...|...|...|...| 2 |   |...|...|...|...|...|...|...|...|...|...|...|...|...|...|...|...|...|...|...|...|...|...|...|...|...|   |...|...|...|...|...|...|...|...|...|...|...|...|...|...|...|...|...|
|...|...|...|...|...|...|...|...|...|...|...|...|...|...|...|...|...|...|  \|   |...|...|...|...|...|...|...|...|...|...|...|...|...|...|...|...|...|...|...|...|...|...|...|...|...|   |...|...|...|...|...|...|...|...|...|...|...|...|...|...|...|...|...|
+---+---+---+---+---+---+---+---+---+---+---+---+---+---+---+---+---+---+---+---+---+---+---+---+---+---+---+---+---+---+---+---+---+---+---+---+---+---+---+---+---+---+---+---+---+---+---+---+---+---+---+---+---+---+---+---+---+---+---+---+---+---+---+
|...|...|...|...|...|...|...|...|...|...|...|...|...|...|...|...|...|...|   |\  |...|...|...|...|...|...|...|   |   |   |   |   |   |   |...|...|...|...|...|...|...|...|...|...|   |   |   |   |   |   |   |...|...|...|...|...|...|...|...|...|...|...|...|
|...|...|...|...|...|...|...|...|...|...|...|...|...|...|...|...|...|...|   | 2 |...|...|...|...|...|...|...| 3-|-2-|-2-|-2-|-2-|-3 |   |...|...|...|...|...|...|...|...|...|...|   |   |   |   |   |   |   |...|...|...|...|...|...|...|...|...|...|...|...|
|...|...|...|...|...|...|...|...|...|...|...|...|...|...|...|...|...|...|   |  \|...|...|...|...|...|...|...|/  |   |   |   |   |  \|   |...|...|...|...|...|...|...|...|...|...|   |   |   |   |   |   |   |...|...|...|...|...|...|...|...|...|...|...|...|
+---+---+---+---+---+---+---+---+---+---+---+---+---+---+---+---+---+---+---+---+---+---+---+---+---+---+---+---+---+---+---+---+---+---+---+---+---+---+---+---+---+---+---+---+---+---+---+---+---+---+---+---+---+---+---+---+---+---+---+---+---+---+---+
|...|...|...|...|...|...|...|...|...|...|...|...|...|...|...|...|...|...|...|   |\  |...|   |   |   |   |  /|   |   |...|...|   |   |\  |   |...|...|...|...|...|...|...|...|...|...|...|   |   |   |   |   |   |   |   |   |...|...|...|...|...|...|...|...|
|...|...|...|...|...|...|...|...|...|...|...|...|...|...|...|...|...|...|...|   | 2 |...|   | 3-|-2-|-2-|-3 |   |   |...|...|   |   | 2 |   |...|...|...|...|...|...|...|...|...|...|...|   |   |   |   |   |   |   |   |   |...|...|...|...|...|...|...|...|
|...|...|...|...|...|...|...|...|...|...|...|...|...|...|...|...|...|...|...|   |  \|...|   |/  |   |   |   |   |   |...|...|   |   |  \|   |...|...|...|...|...|...|...|...|...|...|...|   |   |   |   |   |   |   |   |   |...|...|...|...|...|...|...|...|
+---+---+---+---+---+---+---+---+---+---+---+---+---+---+---+---+---+---+---+---+---+---+---+---+---+---+---+---+---+---+---+---+---+---+---+---+---+---+---+---+---+---+---+---+---+---+---+---+---+---+---+---+---+---+---+---+---+---+---+---+---+---+---+
|...|...|...|...|...|...|...|...|...|...|...|...|...|...|...|...|...|...|...|...|...|\  |  /|...|...|...|...|...|...|...|...|   |   |   |\  |   |   |   |...|...|...|...|...|...|...|...|...|...|...|...|...|   |   |   |   |...|...|...|...|...|...|...|...|
|...|...|...|...|...|...|...|...|...|...|...|...|...|...|...|...|...|...|...|...|...| 3-|-3 |...|...|...|...|...|...|...|...|   |   |   | 2 |   |   |   |...|...|...|...|...|...|...|...|...|...|...|...|...|   |   |   |   |...|...|...|...|...|...|...|...|
|...|...|...|...|...|...|...|...|...|...|...|...|...|...|...|...|...|...|...|...|...|   |   |...|...|...|...|...|...|...|...|   |   |   |  \|   |   |   |...|...|...|...|...|...|...|...|...|...|...|...|...|   |   |   |   |...|...|...|...|...|...|...|...|
+---+---+---+---+---+---+---+---+---+---+---+---+---+---+---+---+---+---+---+---+---+---+---+---+---+---+---+---+---+---+---+---+---+---+---+---+---+---+---+---+---+---+---+---+---+---+---+---+---+---+---+---+---+---+---+---+---+---+---+---+---+---+---+
|...|...|...|...|...|...|...|...|...|...|...|...|   |   |   |   |   |   |   |...|...|...|...|...|...|...|...|...|...|...|...|...|...|...|...|\  |   |   |...|...|...|...|...|...|...|...|...|...|...|...|...|...|   |   |   |...|...|...|...|...|...|...|...|
|...|...|...|...|...|...|...|...|...|...|...|...|   |   | 3-|-2-|-2-|-3 |   |...|...|...|...|...|...|...|...|...|...|...|...|...|...|...|...| 3 |   |   |...|...|...|...|...|...|...|...|...|...|...|...|...|...|   |   |   |...|...|...|...|...|...|...|...|
|...|...|...|...|...|...|...|...|...|...|...|...|   |   |/  |   |   |  \|   |...|...|...|...|...|...|...|...|...|...|...|...|...|...|...|...| | |   |   |...|...|...|...|...|...|...|...|...|...|...|...|...|...|   |   |   |...|...|...|...|...|...|...|...|
+---+---+---+---+---+---+---+---+---+---+---+---+---+---+---+---+---+---+---+---+---+---+---+---+---+---+---+---+---+---+---+---+---+---+---+---+---+---+---+---+---+---+---+---+---+---+---+---+---+---+---+---+---+---+---+---+---+---+---+---+---+---+---+
|...|...|...|...|...|...|...|...|...|...|...|...|   |  /|   |...|...|...|\  |   |   |...|...|...|...|...|...|...|...|...|...|...|...|...|...| | |   |   |...|...|...|...|...|...|...|...|...|...|...|...|...|...|   |   |   |...|...|...|...|...|...|...|...|
|...|...|...|...|...|...|...|...|...|...|...|...|   | 2 |   |...|...|...| 3 |   |   |...|...|...|...|...|...|...|...|...|...|...|...|...|...| 2 |   |   |...|...|...|...|...|...|...|...|...|...|...|...|...|...|   |   |   |...|...|...|...|...|...|...|...|
|...|...|...|...|...|...|...|...|...|...|...|...|   |/  |   |...|...|...| | |   |   |...|...|...|...|...|...|...|...|...|...|...|...|...|...| | |   |   |...|...|...|...|...|...|...|...|...|...|...|...|...|...|   |   |   |...|...|...|...|...|...|...|...|
+---+---+---+---+---+---+---+---+---+---+---+---+---+---+---+---+---+---+---+---+---+---+---+---+---+---+---+---+---+---+---+---+---+---+---+---+---+---+---+---+---+---+---+---+---+---+---+---+---+---+---+---+---+---+---+---+---+---+---+---+---+---+---+
|...|...|...|...|...|...|...|...|...|...|...|   |  /|...|...|...|...|...| | |   |   |...|...|...|...|...|...|...|...|...|...|...|...|...|...| | |   |   |...|...|...|...|...|...|...|...|...|...|...|...|...|...|   |   |   |...|...|...|...|...|...|...|...|
|...|...|...|...|...|...|...|...|...|...|...|   | 3 |...|...|...|...|...| 2 |   |   |...|...|...|...|...|...|...|...|...|...|...|...|...|...| 3 |   |   |...|...|...|...|...|...|...|...|...|...|...|...|...|...|   |   |   |...|...|...|...|...|...|...|...|
|...|...|...|...|...|...|...|...|...|...|...|   | | |...|...|...|...|...| | |   |   |...|...|...|...|...|...|...|...|...|...|...|...|...|...|/  |   |   |...|...|...|...|...|...|...|...|...|...|...|...|...|...|   |   |   |...|...|...|...|...|...|...|...|
+---+---+---+---+---+---+---+---+---+---+---+---+---+---+---+---+---+---+---+---+---+---+---+---+---+---+---+---+---+---+---+---+---+---+---+---+---+---+---+---+---+---+---+---+---+---+---+---+---+---+---+---+---+---+---+---+---+---+---+---+---+---+---+
|...|...|...|...|...|...|...|...|...|...|...|   | | |   |...|...|   |   | | |...|...|...|...|...|...|...|...|...|...|...|   |   |   |   |  /|   |   |   |...|...|...|...|...|...|...|...|...|...|...|...|   |   |   |...|...|...|...|...|...|...|...|...|...|
|...|...|...|...|...|...|...|...|...|...|...|   | 2 |   |...|...|   |   | 2 |...|...|...|...|...|...|...|...|...|...|...| 3-|-2-|-2-|-2-|-3 |   |   |   |...|...|...|...|...|...|...|...|...|...|...|...|   |   |   |...|...|...|...|...|...|...|...|...|...|
|...|...|...|...|...|...|...|...|...|...|...|   | | |   |...|...|   |   | | |...|...|...|...|...|...|...|...|...|...|...|/  |   |   |   |   |   |   |   |...|...|...|...|...|...|...|...|...|...|...|...|   |   |   |...|...|...|...|...|...|...|...|...|...|
+---+---+---+---+---+---+---+---+---+---+---+---+---+---+---+---+---+---+---+---+---+---+---+---+---+---+---+---+---+---+---+---+---+---+---+---+---+---+---+---+---+---+---+---+---+---+---+---+---+---+---+---+---+---+---+---+---+---+---+---+---+---+---+
|...|...|...|...|...|...|...|...|...|...|...|...| | |   |...|...|   |   | | |...|...|...|...|...|...|...|   |   |   |  /|   |...|...|...|...|...|...|...|...|...|...|...|...|...|...|...|...|...|...|...|   |   |   |...|...|...|...|...|...|...|...|...|...|
|...|...|...|...|...|...|...|...|...|...|...|...| 2 |   |...|...|   |   | 3 |...|...|...|...|...|...|...|   |   | 3-|-3 |   |...|...|...|...|...|...|...|...|...|...|...|...|...|...|...|...|...|...|...|   |   |   |...|...|...|...|...|...|...|...|...|...|
|...|...|...|...|...|...|...|...|...|...|...|...| | |   |...|...|   |   |  \|...|...|...|...|...|...|...|   |   |/  |   |   |...|...|...|...|...|...|...|...|...|...|...|...|...|...|...|...|...|...|...|   |   |   |...|...|...|...|...|...|...|...|...|...|
+---+---+---+---+---+---+---+---+---+---+---+---+---+---+---+---+---+---+---+---+---+---+---+---+---+---+---+---+---+---+---+---+---+---+---+---+---+---+---+---+---+---+---+---+---+---+---+---+---+---+---+---+---+---+---+---+---+---+---+---+---+---+---+
|...|...|...|...|...|...|...|...|...|...|...|...| | |   |...|...|...|...|   |\  |   |   |   |   |   |   |   |  /|...|...|...|...|...|...|...|...|...|...|...|...|...|...|...|...|...|...|...|...|...|...|   |   |   |...|...|...|...|...|...|...|...|...|...|
|...|...|...|...|...|...|...|...|...|...|...|...| 2 |   |...|...|...|...|   | 3-|-2-|-2-|-2-|-2-|-2-|-2-|-2-|-3 |...|...|...|...|...|...|...|...|...|...|...|...|...|...|...|...|...|...|...|...|...|...|   |   |   |...|...|...|...|...|...|...|...|...|...|
|...|...|...|...|...|...|...|...|...|...|...|...| | |   |...|...|...|...|   |   |   |   |   |   |   |   |   |   |...|...|...|...|...|...|...|...|...|...|...|...|...|...|...|...|...|...|...|...|...|...|   |   |   |...|...|...|...|...|...|...|...|...|...|
+---+---+---+---+---+---+---+---+---+---+---+---+---+---+---+---+---+---+---+---+---+---+---+---+---+---+---+---+---+---+---+---+---+---+---+---+---+---+---+---+---+---+---+---+---+---+---+---+---+---+---+---+---+---+---+---+---+---+---+---+---+---+---+
|...|...|...|...|...|...|...|...|...|...|...|...| | |   |...|...|...|...|...|...|...|...|...|...|...|   |   |   |...|...|...|...|...|...|...|...|...|...|...|...|...|...|   |   |   |   |   |   |   |   |   |   |   |...|...|...|...|...|...|...|...|...|...|
|...|...|...|...|...|...|...|...|...|...|...|...| 2 |   |...|...|...|...|...|...|...|...|...|...|...|   |   |   |...|...|...|...|...|...|...|...|...|...|...|...|...|...|   |   |   |   |   |   |   |   |   |   |   |...|...|...|...|...|...|...|...|...|...|
|...|...|...|...|...|...|...|...|...|...|...|...| | |   |...|...|...|...|...|...|...|...|...|...|...|   |   |   |...|...|...|...|...|...|...|...|...|...|...|...|...|...|   |   |   |   |   |   |   |   |   |   |   |...|...|...|...|...|...|...|...|...|...|
+---+---+---+---+---+---+---+---+---+---+---+---+---+---+---+---+---+---+---+---+---+---+---+---+---+---+---+---+---+---+---+---+---+---+---+---+---+---+---+---+---+---+---+---+---+---+---+---+---+---+---+---+---+---+---+---+---+---+---+---+---+---+---+
|...|...|...|...|...|...|...|...|...|...|...|...| | |   |...|...|...|...|...|...|...|...|...|...|...|...|   |   |   |...|...|...|...|...|...|...|...|...|...|...|   |   |   |...|...|...|...|...|...|...|...|...|...|...|...|...|...|...|...|...|...|...|...|
|...|...|...|...|...|...|...|...|...|...|...|...| 2 |   |...|...|...|...|...|...|...|...|...|...|...|...|   |   |   |...|...|...|...|...|...|...|...|...|...|...|   |   |   |...|...|...|...|...|...|...|...|...|...|...|...|...|...|...|...|...|...|...|...|
|...|...|...|...|...|...|...|...|...|...|...|...| | |   |...|...|...|...|...|...|...|...|...|...|...|...|   |   |   |...|...|...|...|...|...|...|...|...|...|...|   |   |   |...|...|...|...|...|...|...|...|...|...|...|...|...|...|...|...|...|...|...|...|
+---+---+---+---+---+---+---+---+---+---+---+---+---+---+---+---+---+---+---+---+---+---+---+---+---+---+---+---+---+---+---+---+---+---+---+---+---+---+---+---+---+---+---+---+---+---+---+---+---+---+---+---+---+---+---+---+---+---+---+---+---+---+---+
|...|...|...|...|   |   |   |   |   |   |...|...| | |   |...|...|...|...|...|...|...|...|...|...|...|...|...|...|   |   |   |...|...|...|...|...|...|...|   |   |   |...|...|...|...|...|...|...|...|...|...|...|...|...|...|...|...|...|...|...|...|...|...|
|...|...|...|...|   | 3-|-2-|-2-|-2-|-3 |...|...| 3 |   |...|...|...|...|...|...|...|...|...|...|...|...|...|...|   |   |   |...|...|...|...|...|...|...|   |   |   |...|...|...|...|...|...|...|...|...|...|...|...|...|...|...|...|...|...|...|...|...|...|
|...|...|...|...|   |/  |   |   |   |  \|...|...|/  |   |...|...|...|...|...|...|...|...|...|...|...|...|...|...|   |   |   |...|...|...|...|...|...|...|   |   |   |...|...|...|...|...|...|...|...|...|...|...|...|...|...|...|...|...|...|...|...|...|...|
+---+---+---+---+---+---+---+---+---+---+---+---+---+---+---+---+---+---+---+---+---+---+---+---+---+---+---+---+---+---+---+---+---+---+---+---+---+---+---+---+---+---+---+---+---+---+---+---+---+---+---+---+---+---+---+---+---+---+---+---+---+---+---+
|\  |   |   |   |  /|   |...|...|...|   |\  |  /|   |...|...|...|...|...|...|...|...|...|...|...|...|...|...|...|...|...|   |   |   |   |   |   |   |   |   |   |   |...|...|...|...|...|...|...|...|...|...|...|...|...|...|...|...|...|...|...|...|...|...|
| S |   |   |   | 2 |   |...|...|...|   | 3-|-3 |   |...|...|...|...|...|...|...|...|...|...|...|...|...|...|...|...|...|   |   |   |   |   |   |   |   |   |   |   |...|...|...|...|...|...|...|...|...|...|...|...|...|...|...|...|...|...|...|...|...|...|
|  \|   |   |   |/  |   |...|...|...|   |   |   |   |...|...|...|...|...|...|...|...|...|...|...|...|...|...|...|...|...|   |   |   |   |   |   |   |   |   |   |   |...|...|...|...|...|...|...|...|...|...|...|...|...|...|...|...|...|...|...|...|...|...|
+---+---+---+---+---+---+---+---+---+---+---+---+---+---+---+---+---+---+---+---+---+---+---+---+---+---+---+---+---+---+---+---+---+---+---+---+---+---+---+---+---+---+---+---+---+---+---+---+---+---+---+---+---+---+---+---+---+---+---+---+---+---+---+
|   |\  |   |  /|   |   |...|...|...|...|...|...|...|...|...|...|...|...|...|...|...|...|...|...|...|...|...|...|...|...|...|...|...|...|...|...|...|...|...|...|...|...|...|...|...|...|...|...|...|...|...|...|...|...|...|...|...|...|...|...|...|...|...|
|   | 3-|-2-|-3 |   |   |...|...|...|...|...|...|...|...|...|...|...|...|...|...|...|...|...|...|...|...|...|...|...|...|...|...|...|...|...|...|...|...|...|...|...|...|...|...|...|...|...|...|...|...|...|...|...|...|...|...|...|...|...|...|...|...|...|
|   |   |   |   |   |   |...|...|...|...|...|...|...|...|...|...|...|...|...|...|...|...|...|...|...|...|...|...|...|...|...|...|...|...|...|...|...|...|...|...|...|...|...|...|...|...|...|...|...|...|...|...|...|...|...|...|...|...|...|...|...|...|...|
+---+---+---+---+---+---+---+---+---+---+---+---+---+---+---+---+---+---+---+---+---+---+---+---+---+---+---+---+---+---+---+---+---+---+---+---+---+---+---+---+---+---+---+---+---+---+---+---+---+---+---+---+---+---+---+---+---+---+---+---+---+---+---+
|...|...|...|...|...|...|...|...|...|...|...|...|...|...|...|...|...|...|...|...|...|...|...|...|...|...|...|...|...|...|...|...|...|...|...|...|...|...|...|...|...|...|...|...|...|...|...|...|...|...|...|...|...|...|...|...|...|...|...|...|...|...|...|
|...|...|...|...|...|...|...|...|...|...|...|...|...|...|...|...|...|...|...|...|...|...|...|...|...|...|...|...|...|...|...|...|...|...|...|...|...|...|...|...|...|...|...|...|...|...|...|...|...|...|...|...|...|...|...|...|...|...|...|...|...|...|...|
|...|...|...|...|...|...|...|...|...|...|...|...|...|...|...|...|...|...|...|...|...|...|...|...|...|...|...|...|...|...|...|...|...|...|...|...|...|...|...|...|...|...|...|...|...|...|...|...|...|...|...|...|...|...|...|...|...|...|...|...|...|...|...|
+---+---+---+---+---+---+---+---+---+---+---+---+---+---+---+---+---+---+---+---+---+---+---+---+---+---+---+---+---+---+---+---+---+---+---+---+---+---+---+---+---+---+---+---+---+---+---+---+---+---+---+---+---+---+---+---+---+---+---+---+---+---+---+
