#######.....................###################################
######...#######............###################################
####......H###############......###############################
####......#####################.....###########################
####......#########################........#.#.################
####................#######################.#.#.###############
####................########################.#.################
##################..#########################.#################
##################..#######.......##########.......############
###################..#.......##....###########.........########
#####################..########.......#############....########
############.......################...##############...########
############...###...##############...##############...########
###########..#####...##############...##############...########
###########...##...###########........############...##########
############..##...#######.....###################...##########
############..####..........######################...##########
############..###########...##############...........##########
############..############...###########...####################
####......##..##############...#######...######################
4.....###....#################...........######################
......#########################################################
###############################################################